10 5
##########
#P____T__#
#________#
#____E___#
##########